wwwwwwwwwwwwwwwwwwwwwwwwwwwwwwww
w                      weeew   w
w                        e     w
w                              w
w                              w
w   ww                    ww   w
w   ww                   wwww  w
w   www                wwwwww  w
w                     w        w
w                              w
w                              w
w                              w
w            wwwwww            w
w           w      w           w
w          w        w     wwwwww
w s       w          w   w      
w        ww           www       
wwwwwwwwwww                     
