wwwwwwwwwwwwwwwwwwwwwwwwwwwwwwwwwwwwwwwwww
w                                        w
w                                        w
w                                        w
w                                        w
w                                        w
w                                        w
w                                        w
w                                        w
w                                        w
w                    s                   w
w                                        w
w                   www                  w
w                                        w
w                             eeee       w
w         w                              w
w         w    www     n   m             w
w                                        w
w                                        w
wwwwwwwwwwwwwwwwwwwwwwwwwwwwwwwwwwwwwwwwww
