wwwwwwwwwwwwwwwwwwwwwwwwwwwwwwww
w                      w   w   w
w                              w
w                              w
w                              w
w               eee       ww   w
w               eee      wwwww w
w                      wwwwwwwww
w                     w        |
w                    w         |
w                   w          |
w                  w           |
w            www ww            |
w           w   w              |
w          w                   |
w s       w                    |
w  w     ww                    |
wwww   wwww                    |
