wwwwwwwwwwwwwwwwwwwwwwwwwwwwwwww
w                              w
w                              w
w                              w
w                              w
w                              w
w                              w
w                              w
w                              w
w                              w
w                    s         w
w                              w
w                   www        w
w                              w
w                              w
w         w                    w
w         w    www     n   m   w
wwwwwwwwwwwwwwwwwwwwwwwwwwwwwwww
