wwwwwwwwwwwwwwwwwwwwwwwwwwwwwwwwwwwwwwwwww
w                                        w
w                                        w
w                                        w
w                                        w
w                                        w
w                                        w
w                                        w
w                                        w
w                                        w
w                    s                   w
w                                        w
w                   www                  w
w                                        w
w                                        w
w         w                              w
w         w    www             eeee      w
w                                        w
w                                        w
wwwwwwwwwwwwwwwwwwwwwwwwwwwwwwwwwwwwwwwwww
